10
8
1 8
1 8 
1110000000
1001101111
0010000000
0111110100
0101011001
0001010100
0101010101
0100000000
