12
12
1 12
12 1 
111100000010
000100100010
011100110010
000000000010
111001100010
000001101000
010100001110
010011010010
000001010110
011001010010
001000000100
001000000100
